
                                                                         #####
                                                                         #...#
                                                                         #...#
                                                                         #...#
 #########################################################################...#
 #...........................................................................#
 ######################......................................................#
                      #...............................####################...#####
                      ############....................#..........................#
                      #...............................#..........................#
                      #...............................#..........................#
                      #..........................................................#
                      #..........##################..............................#
                      #..........................................................#
 ######################..........................................................#
 #...............................................................................#
 #################################################################################



                      
