

                                                             ###########
                          ##########                         #.........#
                          #........#                         #.........#
                          #........#                         #.........#
                          #........#                         #.........#
 ##########################........###########################.........#
 #.....................................................................#
 #.....................................................................#
 #.....................................................................#
 ##########################........#######################.............#
                          #........#                     #.............#
                          ##########                     #.............#
                                                         ###############
