################
#..............#
#..............#
#..............#
#..............#
#..............#
#..............#
#..............#
#..............#############################################
#..........................................................#
#..........................................................#
#..........................................................#
#..........................................................#
#..........................................................#
#..........................................................#
###########################################................#
                                          #................#
                                          #................#
                                          #................#
                                          #................#
                                          ################## 



